6 14
|------------|
|...|...|....|
|...|___|....|
|........--..|
|...@........|
|------------|

