8 14
|------------|
|............|
|...|..@|....|
|...|___|....|
|.........--.|
|............|
|------------|  

