6 14
|------------|
|...|........|
|...|--......|
|........--..|
|...@........|
|------------|

