8 14
|------------|
|F...........|
|...|..@|....|
|...|___|....|
|.........--.|
|F...........|
|------------|  

